11111111111111111
10111000011110101
10110000111110101
10100000000110101
10111111111110001
10000000000000001
11111111111111111